#include <iostream>
using namespace std;


int main() {


	setlocale(0, "");

	cout << "Программа - “Лабиринт”\n\n";
	cout << "Размер карты\n";
	cout << "[1]15 x 15\n";
	cout << "[2]20 x 20\n";
	cout << "[3]30 x 30\n\n";
	cout << "Выберите размер: ";

	int  menu;
	cin >> menu;
	if (menu == 1) {

		int arr[15][15] = {
			{1,1,0,0,0,1,1,1,1,1,1,1,1,1,1},
			{1,1,0,0,0,1,1,1,1,1,1,1,1,1,1},
			{1,1,0,0,0,0,0,0,0,0,0,1,1,1,1},
			{1,1,0,0,0,0,0,0,0,0,0,1,1,1,1},
			{1,1,1,1,1,1,1,1,0,0,0,1,1,1,1},
			{1,1,1,1,1,1,1,1,0,0,0,1,1,1,1},
			{1,1,1,1,1,1,1,1,0,0,0,0,0,1,1},
			{1,1,1,1,1,1,1,1,0,0,0,0,0,1,1},
			{1,1,1,1,0,0,0,0,0,0,0,1,1,1,1},
			{1,1,1,1,0,0,0,0,0,0,0,1,1,1,1},
			{1,1,1,1,0,0,0,1,1,1,1,1,1,1,1},
			{1,1,1,1,0,0,0,0,0,0,0,0,1,1,1},
			{1,1,1,1,0,0,0,0,0,0,0,0,1,1,1},
			{1,1,1,1,1,1,1,1,1,0,0,0,1,1,1},
			{1,1,1,1,1,1,1,1,1,0,0,0,1,1,1}

		};
		for (int i = 0; i < 15; i++) {

			for (int k = 0; k < 15; k++) {
				if (arr[i][k] == 1) {
					cout << "# " ;
				}
				else {
					cout << "  " ;
				}
				
			}
			cout << "\n";

		}
	}

		if (menu == 2) {

			int arr[20][20] = {

				{1,1,1,0,0,0,0,1,1,1,1,1,1,1,1,1,1,1,1,1},
				{1,1,1,0,0,0,0,1,1,1,1,1,1,1,1,1,1,1,1,1},
				{1,1,1,0,0,0,0,0,0,0,0,0,0,0,0,0,0,1,1,1},
				{1,1,1,0,0,0,0,0,0,0,0,0,0,0,0,0,0,1,1,1},
				{1,1,1,0,0,0,0,0,0,0,1,1,1,1,1,0,0,1,1,1},
				{1,1,1,1,1,1,1,1,1,1,1,1,1,1,1,0,0,1,1,1},
				{1,1,1,1,1,1,1,1,1,1,1,1,1,1,1,0,0,1,1,1},
				{1,1,1,1,1,1,1,1,1,1,1,1,1,1,1,0,0,1,1,1},
				{1,1,1,1,1,1,1,1,1,1,1,1,1,1,1,0,0,1,1,1},
				{1,1,1,1,1,0,0,0,0,0,0,0,0,0,0,0,0,1,1,1},
				{1,1,1,1,1,0,0,0,0,0,0,0,0,0,0,0,0,1,1,1},
				{1,1,1,1,1,0,0,1,1,1,1,1,1,1,1,1,1,1,1,1},
				{1,1,1,1,1,0,0,1,1,1,1,1,1,1,1,1,1,1,1,1},
				{1,1,1,1,1,0,0,1,1,1,1,1,1,1,1,1,1,1,1,1},
				{1,1,1,1,1,0,0,1,1,1,1,1,1,1,1,1,1,1,1,1},
				{1,1,1,1,1,0,0,1,1,1,1,1,1,1,1,1,1,1,1,1},
				{1,1,1,1,1,0,0,0,0,0,0,0,0,0,0,0,0,0,1,1},
				{1,1,1,1,1,0,0,0,0,0,0,0,0,0,0,0,0,0,1,1},
				{1,1,1,1,1,1,1,1,1,1,1,1,1,1,1,0,0,0,1,1},
				{1,1,1,1,1,1,1,1,1,1,1,1,1,1,1,0,0,0,1,1}



			};
			for (int f = 0; f < 20; f++) {

				for (int l = 0; l < 20; l++) {
					if (arr[f][l] == 1) {
						cout << "# ";
					}
					else {
						cout << "  ";
					}

				}
				cout << "\n";

			}
		}

		if (menu == 3) {

			int arr[30][30] = {

				
				{1,1,1,1,1,1,1,1,1,1,1,1,1,1,1,1,1,1,1,1,1,1,1,1,1,1,1,1,1,0},
				{1,1,1,1,1,1,1,0,0,0,0,1,1,1,1,1,1,1,1,0,0,0,0,1,1,1,1,1,0,1},
				{1,1,1,1,1,1,0,1,1,1,1,0,1,1,1,1,1,1,0,1,1,1,1,0,1,1,1,0,1,1},
				{1,1,1,1,1,0,1,1,1,1,1,1,0,1,1,1,1,0,1,1,1,1,1,1,0,1,0,1,1,1},
				{1,1,1,1,0,1,1,1,1,1,1,1,1,0,1,1,0,1,1,1,1,1,1,1,1,0,1,1,1,1},
				{1,1,1,0,1,1,1,1,1,1,1,1,1,1,0,0,1,1,1,1,1,1,1,1,0,1,0,1,1,1},
				{1,1,0,1,1,1,1,1,1,1,1,1,1,1,1,1,1,1,1,1,1,1,1,0,1,1,1,0,1,1},
				{1,1,0,1,1,1,1,1,1,1,1,1,1,1,1,1,1,1,1,1,1,1,0,1,1,1,1,0,1,1},
				{1,1,0,1,1,1,1,1,1,1,1,1,1,1,1,1,1,1,1,1,1,0,1,1,1,1,1,0,1,1},
				{1,1,0,1,1,1,1,1,1,1,1,1,1,1,1,1,1,1,1,1,0,1,1,1,1,1,1,0,1,1},
				{1,1,0,1,1,1,1,1,1,1,1,1,1,1,1,1,1,1,1,0,1,1,1,1,1,1,1,0,1,1},
				{1,1,0,1,1,1,1,1,1,1,1,1,1,1,1,1,1,1,0,1,1,1,1,1,1,1,1,0,1,1},
				{1,1,0,1,1,1,1,1,1,1,1,1,1,1,1,1,1,0,1,1,1,1,1,1,1,1,1,0,1,1},
				{1,1,0,1,1,1,1,1,1,1,1,1,1,1,1,1,0,1,1,1,1,1,1,1,1,1,1,0,1,1},
				{1,1,1,0,1,1,1,1,1,1,1,1,1,1,1,0,1,1,1,1,1,1,1,1,1,1,0,1,1,1},
				{1,1,1,1,0,1,1,1,1,1,1,1,1,1,0,1,1,1,1,1,1,1,1,1,1,0,1,1,1,1},
				{1,1,1,1,1,0,1,1,1,1,1,1,1,0,1,1,1,1,1,1,1,1,1,1,0,1,1,1,1,1},
				{1,1,1,1,1,1,0,1,1,1,1,1,0,1,1,1,1,1,1,1,1,1,1,0,1,1,1,1,1,1},
				{1,1,1,1,1,1,1,0,1,1,1,0,1,1,1,1,1,1,1,1,1,1,0,1,1,1,1,1,1,1},
				{1,1,1,1,1,1,1,1,0,1,0,1,1,1,1,1,1,1,1,1,1,0,1,1,1,1,1,1,1,1},
				{1,1,1,1,1,1,1,1,1,0,1,1,1,1,1,1,1,1,1,1,0,1,1,1,1,1,1,1,1,1},
				{1,1,1,1,1,1,1,1,0,1,0,1,1,1,1,1,1,1,1,0,1,1,1,1,1,1,1,1,1,1},
				{1,1,1,1,1,1,1,0,1,1,1,0,1,1,1,1,1,1,0,1,1,1,1,1,1,1,1,1,1,1},
				{1,1,1,1,1,1,0,1,1,1,1,1,0,1,1,1,1,0,1,1,1,1,1,1,1,1,1,1,1,1},
				{1,0,1,1,1,0,1,1,1,1,1,1,1,0,1,1,0,1,1,1,1,1,1,1,1,1,1,1,1,1},
				{1,0,1,1,0,1,1,1,1,1,1,1,1,1,0,0,1,1,1,1,1,1,1,1,1,1,1,1,1,1},
				{1,0,1,0,1,1,1,1,1,1,1,1,1,1,1,1,1,1,1,1,1,1,1,1,1,1,1,1,1,1},
				{1,0,0,1,1,1,1,1,1,1,1,1,1,1,1,1,1,1,1,1,1,1,1,1,1,1,1,1,1,1},
				{1,0,0,0,0,0,1,1,1,1,1,1,1,1,1,1,1,1,1,1,1,1,1,1,1,1,1,1,1,1},
				{1,1,1,1,1,1,1,1,1,1,1,1,1,1,1,1,1,1,1,1,1,1,1,1,1,1,1,1,1,1},



			};
			for (int h = 0; h < 30; h++) {

				for (int a = 0; a < 30; a++) {
					if (arr[h][a] == 1) {
						cout << "# ";
					}
					else {
						cout << "  ";
					}

				}
				cout << "\n";

			}
		}
	
	int _;
	cin >> _;
	return 0;
}
